{
    "level": 1,
    "map": {
        "size_x": 10,
        "size_y": 10,
        "position": [
            
        ],

        "map": [
            [0, 0, 0, 0, 0, 0, 0, 0, 0, 0], 
            [1, 0, 0, 0, 0, 1, 0, 0, 0, 0],
            [1, 1, 0, 0, 1, 1, 0, 0, 0, 0],
            [1, 0, 0, 0, 0, 1, 0, 0, 0, 0],
            [1, 0, 0, 0, 0, 1, 1, 1, 0, 0],
            [1, 0, 0, 0, 0, 1, 1, 1, 0, 0],
            [0, 0, 0, 0, 0, 0, 0, 0, 0, 0], 
            [0, 0, 0, 0, 0, 0, 0, 0, 0, 0], 
            [0, 0, 0, 0, 0, 0, 0, 0, 0, 0], 
            [0, 0, 0, 0, 0, 0, 0, 0, 0, 0] 
        ]
    },
    "objects": [
        ["PacMan", [1, 1]]
    ]
}
